000000000000
000000000000
000000000000
d11110000000
000010000000
000010000000
00001111111f
000000000000
000000000000
000000000000
000000000000
000000000000
