000000000000
d11110000000
000010000000
000011100000
000000100000
00111110001f
001000000010
001000001110
111000001000
100000001000
111111111000
000000000000


