00d000000000
001000000000
001111111110
000000000010
001111111110
001000000000
001111111110
000000000010
001111111110
001000000000
001111111110
0000000000f0
