000000000000
000000000000
01111110111f
010000101000
011110111000
000010000000
011110000000
01000000001d
010000000010
010000000010
011111111110
000000000000
