000000000000
000000000000
000000000000
000000000000
d11100000000
000100000000
00011111111f
000000000000
000000000000
000000000000
000000000000
000000000000
